##########################
#.........#....#.........#
#.#######.#.##.#.#######.#
#.#######.#.##.#.#######.#
#.##........##........##.#
#.##.##.###.##.###.##.##.#
#....##.###.##.###.##....#
####.##.###.##.###.##.####
####.##............##.####
.....####.######.####.....
#.##.####.######.####.##.#
#.##..................##.#
#.####.##.######.##.####.#
#.####.##.#A..B#.##.####.#
#......##.#....#.##......#
#.##.####.#C..D#.####.##.#
#.##.####.######.####.##.#
#.##........1.........##.#
#.####.####.##.####.####.#
#.####.####.##.####.####.#
#......##...##...##......#
###.##.##.######.##.##.###
###.##.##.######.##.##.###
#...##..............##...#
#.####.####.##.####.####.#
#.####.####.##.####.####.#
#......##...##...##......#
#.####.##.######.##.####.#
#.####.##.######.##.####.#
#......##........##......#
##########################